# added postag entries
#-------------------------------------------------------------------------------
# Do not add words here, but report them to languagetool@taaltik.nl
#-------------------------------------------------------------------------------
bierdrinken	bierdrinken	WKW:TGW:INF
boefachtige	boefachtige	BNW:STL:VRB
chaptaliseren	chaptaliseren	WKW:TGW:INF
chocoladen	chocoladen	BNW:STF
geocachen	geocachen	WKW:TGW:INF
gezeikte	zeiken	WKW:VTD:VRB
kickboxen	kickboxen	WKW:TGW:INF
lapdancen	lapdancen	WKW:TGW:INF
linedancen	linedancen	WKW:TGW:INF
lp	lp	ZNW:EKV:DE_
mentaliseren	mentaliseren	WKW:TGW:INF
neder	neder	VRZ
paalklimmen	paalklimmen	WKW:INF:ZNW:HET
paalwerpen	paalwerpen	WKW:INF:ZNW:HET
paardansen	paardansen	WKW:INF:ZNW:HET
parapenten	parapenten	WKW:INF:ZNW:HET
pentekenen	pentekenen	WKW:INF:ZNW:HET
penvissen	penvissen	WKW:INF:ZNW:HET
pianostemmen	pianostemmen	WKW:INF:ZNW:HET
pijplassen	pijplassen	WKW:INF:ZNW:HET
pleinspelen	pleinspelen	WKW:INF:ZNW:HET
proefeten	proefeten	WKW:INF:ZNW:HET
proefsporten	proefsporten	WKW:INF:ZNW:HET
pulskiezen	pulskiezen	WKW:INF:ZNW:HET
pulsvissen	pulsvissen	WKW:INF:ZNW:HET
rietzeilen	rietzeilen	WKW:INF:ZNW:HET
rondhaken	rondhaken	WKW:INF:ZNW:HET
ropeskippen	ropeskippen	WKW:INF:ZNW:HET
sausspuiten	sausspuiten	WKW:INF:ZNW:HET
taaldrukken	taaldrukken	WKW:INF:ZNW:HET
taperen	taperen	WKW:INF:ZNW:HET
terneer	terneer	BYW
teweeg	teweeg	BYW
toonkiezen	toonkiezen	WKW:INF:ZNW:HET
turfgraven	turfgraven	WKW:INF:ZNW:HET
wanten	wanten	WKW:INF:ZNW:HET
webcasten	webcasten	WKW:INF:ZNW:HET
webshoppen	webshoppen	WKW:INF:ZNW:HET
wegwielrennen	wegwielrennen	WKW:INF:ZNW:HET
welslagen	welslagen	ZNW:EKV:HET
werelddansen	werelddansen	WKW:INF:ZNW:HET
wildbreien	wildbreien	WKW:INF:ZNW:HET
windowshoppen	windowshoppen	WKW:INF:ZNW:HET
woningdelen	woningdelen	WKW:INF:ZNW:HET
wrakvissen	wrakvissen	WKW:INF:ZNW:HET
zalmvissen	zalmvissen	WKW:INF:ZNW:HET
zandschilderen	zandschilderen	WKW:INF:ZNW:HET
zonnekloppen	zonnekloppen	WKW:INF:ZNW:HET
zoogenten	zoogenten	WKW:INF:ZNW:HET
zwartkrassen	zwartkrassen	WKW:INF:ZNW:HET
aanklevenden	aankleven	WKW:ODW:MRV:DE_
medeontwikkelen	medeontwikkelen	WKW:TGW:INF
vonniswijzen	vonniswijzen	WKW:INF:ZNW:HET
reclamevoeren	reclamevoeren	WKW:INF:ZNW:HET
zwaardlopen	zwaardlopen	WKW:INF:ZNW:HET
roedelopen	roedelopen	WKW:INF:ZNW:HET
planklopen	planklopen	WKW:INF:ZNW:HET
schelpenvissen	schelpenvissen	WKW:INF:ZNW:HET
overarticuleren	overarticuleren	WKW:TGW:INF
wegsodemieteren	wegsodemieteren	WKW:TGW:INF
overbevoorraden	overbevoorraden	WKW:TGW:INF
teleur	teleur	BYW
zittenblijven	zittenblijven	WKW:INF:ZNW:HET
prijsschieten	prijsschieten	WKW:INF:ZNW:HET
zorgsparen	zorgsparen	WKW:INF:ZNW:HET
geplachte	plegen	WKW:VTD:VRB
wildwaterkanoën	wildwaterkanoën	WKW:INF:ZNW:HET
dubbelzien	dubbelzien	WKW:TGW:INF
pensioensparen	pensioensparen	WKW:INF:ZNW:HET
portrettekenen	portrettekenen	WKW:INF:ZNW:HET
wildplakken	wildplakken	WKW:INF:ZNW:HET
buite	uitbuiten	WKW:AWS:LOS
ziekzoeken	ziekzoeken	WKW:INF:ZNW:HET
golfsurfen	golfsurfen	WKW:TGW:INF
wrakduiken	wrakduiken	WKW:INF:ZNW:HET
dropshotten	dropshotten	WKW:TGW:INF
auralezen	auralezen	WKW:TGW:INF
gerede	reden	WKW:VTD:VRB
zwolg	zwelgen	WKW:VLT:1EP
bumperen	bumperen	WKW:TGW:INF
rotsklimmen	rotsklimmen	WKW:INF:ZNW:HET
praktijkleren	praktijkleren	WKW:INF:ZNW:HET
patroontekenen	patroontekenen	WKW:INF:ZNW:HET
gescheerde	scheren	WKW:VTD:VRB
tuinvriend	tuinvriend	ZNW:EKV:DE_
wegis	wegwezen	WKW:TGW:3EP
wadvaren	wadvaren	WKW:INF:ZNW:HET
carnavallen	carnavallen	WKW:TGW:INF
pimpampet	pimpampetten	WKW:TGW:1EP
plankzeilen	plankzeilen	WKW:INF:ZNW:HET
bingewatchen	bingewatchen	WKW:TGW:INF
borstcrawlen	borstcrawlen	WKW:TGW:INF
partycrashen	partycrashen	WKW:INF:ZNW:HET
challengen	challengen	WKW:TGW:INF
saunaën	saunaën	WKW:INF:ZNW:HET
refluxen	refluxen	WKW:INF:ZNW:HET
gequoteerden	quoteren	WKW:VTD:ZNW:MRV:DE_
afdroppelen	afdroppelen	WKW:TGW:INF
afdruiping	afdruiping	ZNW:EKV:DE_
agiotage	agiotage	ZNW:EKV:DE_
coïncident	coïncident	ZNW:EKV:HET
droppeling	droppeling	ZNW:EKV:DE_
gevlerkt	gevlerkt	BNW:STL:ONV
heensnellen	heensnellen	WKW:TGW:INF
heenvoeren	heenvoeren	WKW:TGW:INF
hertsleren	hertsleren	BNW:STF
huurdersverzet	huurdersverzet	ZNW:EKV:HET
javakoffie	javakoffie	ZNW:EKV:DE_
kinderburcht	kinderburcht	ZNW:EKV:DE_
kleptofobie	kleptofobie	ZNW:EKV:DE_
macadamiseren	macadamiseren	WKW:TGW:INF
misogamie	misogamie	ZNW:EKV:DE_
moreen	moreen	ZNW:EKV:DE_
narcotine	narcotine	ZNW:EKV
nettenknoper	nettenknoper	ZNW:EKV:DE_
oceaanhaven	oceaanhaven	ZNW:EKV:DE_
omspoken	omspoken	WKW:TGW:INF
onderom	onderom	BYW
opponens	opponens	ZNW:EKV:DE_
pleten	pleten	BNW:STF
pummelig	pummelig	BNW:STL:ONV
rechtopgezet	rechtopgezet	BNW:STL:ONV
ressource	ressource	ZNW:EKV:DE_
spreukachtig	spreukachtig	BNW:STL:ONV
vitamineloos	vitamineloos	BNW:STL:ONV
voeteren	voeteren	WKW:TGW:INF
vroedkundig	vroedkundig	BNW:STL:ONV
wanschapenheid	wanschapenheid	ZNW:EKV:DE_
welberaden	welberaden	BNW:STL:ONV
hatsiekadee	hatsiekadee	TSW
magelhaengans	magelhaengans	ZNW:EKV:DE_
asielverlener	asielverlener	ZNW:EKV:DE_
augustijns	augustijns	BNW:STL:ONV
afvalplant	afvalplant	ZNW:EKV:DE_
toverformulieren	toverformulier	ZNW:MRV:DE_
barstvrij	barstvrij	BNW:STL:ONV
stompvrij	stompvrij	BNW:STL:ONV
bendevrij	bendevrij	BNW:STL:ONV
werkmatig	werkmatig	BNW:STL:ONV
nagelvrij	nagelvrij	BNW:STL:ONV
glansvrij	glansvrij	BNW:STL:ONV
antizwart	antizwart	BNW:STL:ONV
stukgaand	stukgaand	BNW:STL:ONV
bomenvrij	bomenvrij	BNW:STL:ONV
dwangvrij	dwangvrij	BNW:STL:ONV
inlegvrij	inlegvrij	BNW:STL:ONV
broeivrij	broeivrij	BNW:STL:ONV
tepelpomp	tepelpomp	ZNW:EKV:DE_
claimvrij	claimvrij	BNW:STL:ONV
plantvrij	plantvrij	BNW:STL:ONV
kolenvrij	kolenvrij	BNW:STL:ONV
drugskater	drugskater	ZNW:EKV:DE_
plaagvrij	plaagvrij	BNW:STL:ONV
hagelvrij	hagelvrij	BNW:STL:ONV
kippenmaïs	kippenmaïs	ZNW:EKV:HET
ringmeesteren	ringmeesteren	WKW:INF:ZNW:HET
zuigwortel	zuigwortel	ZNW:EKV:DE_
rijstvrij	rijstvrij	BNW:STL:ONV
stoorvrij	stoorvrij	BNW:STL:ONV
enzymvrij	enzymvrij	BNW:STL:ONV
snoekvrij	snoekvrij	BNW:STL:ONV
milieuauto	milieuauto	ZNW:EKV:DE_
drugskaters	drugskater	ZNW:MRV:DE_
jazzzaal	jazzzaal	ZNW:EKV:DE_
woonfort	woonfort	ZNW:EKV:HET
eindenquête	eindenquête	ZNW:EKV:DE_
uitreispoging	uitreispoging	ZNW:EKV:DE_
hotelvoordeel	hotelvoordeel	ZNW:EKV:HET
robotvrij	robotvrij	BNW:STL:ONV
zomerbank	zomerbank	ZNW:EKV:DE_
inrijtarieven	inrijtarief	ZNW:MRV:DE_
inrijtarief	inrijtarief	ZNW:EKV:HET
oppasrobot	oppasrobot	ZNW:EKV:DE_
hennepdeal	hennepdeal	ZNW:EKV:DE_
gipskopie	gipskopie	ZNW:EKV:DE_
armoedemeter	armoedemeter	ZNW:EKV:DE_
plankend	planken	WKW:ODW:ONV
plankende	planken	WKW:ODW:VRB
plankt	planken	WKW:TGW:3EP
plankten	planken	WKW:VLT:INF
zeevissen	zeevissen	WKW:INF:ZNW:HET
ab	ab	BYW
profilen	profilen	WKW:INF:ZNW:HET
idealegaswet	idealegaswet	ZNW:EKV:DE_
modejournaals	modejournaal	ZNW:MRV:DE_
sluikhandelaars	sluikhandelaar	ZNW:MRV:DE_
sluikhandelaren	sluikhandelaar	ZNW:MRV:DE_
tichelbakkers	tichelbakker	ZNW:MRV:DE_
service-experts	service-expert	ZNW:MRV:DE_
kabelbaanstoeltjes	kabelbaanstoeltje	ZNW:MRV:VRK:DE_
aangedrevene	aandrijven	WKW:VTD:ZNW:EKV
ontstellende	ontstellen	WKW:ODW:VRB
overheersten	overheersen	WKW:VLT:INF
uitgeleiden	uitgeleiden	WKW:VTD:ZNW:MRV:DE_
uitpondende	uitponden	WKW:ODW:VRB
uitspuit	uitspuiten	WKW:TGW:3EP
uniformiseert	uniformiseren	WKW:TGW:3EP
uniformiseerden	uniformiseren	WKW:VLT:INF
verplichtende	verplichten	WKW:ODW:VRB
voorzieniger	voorzienig	BNW:VGR:ONV
speendesinfectiemiddelen	speendesinfectiemiddel	ZNW:MRV:DE_
gezworene	zweren	WKW:VTD:ZNW:EKV
gezworenen	zweren	WKW:VTD:ZNW:MRV:DE_
afgezworven	afzwerven	WKW:VTD:VRB
gitaarspelen	gitaarspelen	WKW:TGW:INF
doorvoeden	doorvoeden	WKW:VTD:ZNW:MRV:DE_
hooggeschat	hooggeschat	BNW:STL:ONV
uitstootrecht	uitstootrecht	ZNW:EKV:HET
visrest	visrest	ZNW:EKV:DE_
vogelrest	vogelrest	ZNW:EKV:DE_
vooruitwijzing	vooruitwijzing	ZNW:EKV:DE_
kraaienveren	kraaienveer	ZNW:MRV:DE_
stuifvrije	stuifvrij	BNW:STL:VRB
aanwezende	aanwezend	BNW:STL:VRB
aanwezenden	aanwezend	BNW:STL:MRV:DE_
bloemloze	bloemloos	BNW:STL:VRB
bloemloos	bloemloos	BNW:STL:IET
braamloos	braamloos	BNW:STL:IET
vooruitwijzingen	vooruitwijzing	ZNW:MRV:DE_
goedverkochte	goedverkocht	BNW:STL:VRB
hooggeschatte	hooggeschat	BNW:STL:VRB
rechtopgezette	rechtopgezet	BNW:STL:VRB
heengevoerd	heenvoeren	WKW:VTD:ONV
heenvoer	heenvoeren	WKW:TGW:1EP
heenvoerde	heenvoeren	WKW:VLT:1EP
heenvoerden	heenvoeren	WKW:VLT:INF
heenvoert	heenvoeren	WKW:TGW:3EP
moltonnen	moltonnen	BNW:STF
voeter	voeteren	WKW:TGW:1EP
augustijnse	augustijns	BNW:STL:VRB
augustijns	augustijns	BNW:STL:IET
welberaden	welberaden	BNW:STL:VRB
ressources	ressource	ZNW:MRV:DE_
diepdenkende	diepdenkend	BNW:STL:VRB
aankappen	aankappen	WKW:TGW:INF
aangekapt	aankappen	WKW:VTD:ONV
aangekapte	aankappen	WKW:VTD:VRB
aankap	aankappen	WKW:TGW:1EP
aankappend	aankappen	WKW:ODW:ONV
aankappende	aankappen	WKW:ODW:VRB
aankapt	aankappen	WKW:TGW:3EP
draadstuk	draadstuk	ZNW:EKV:HET
draadstukje	draadstuk	ZNW:EKV:VRK:HET
draadstukjes	draadstuk	ZNW:MRV:VRK:DE_
draadstukken	draadstuk	ZNW:MRV:DE_
fruitrijke	fruitrijk	BNW:STL:VRB
fruitrijker	fruitrijk	BNW:VGR:ONV
keuzeloze	keuzeloos	BNW:STL:VRB
keuzeloos	keuzeloos	BNW:STL:IET
mucuslaag	mucuslaag	ZNW:EKV:DE_
mucuslagen	mucuslaag	ZNW:MRV:DE_
tempoloze	tempoloos	BNW:STL:VRB
tempoloos	tempoloos	BNW:STL:IET
pauzeloos	pauzeloos	BNW:STL:IET
bleeklila	bleeklila	BNW:STL:VRB
kerkgaanden	kerkgaand	BNW:STL:MRV:DE_
onbevaren	onbevaren	BNW:STL:VRB
faustisch	faustisch	BNW:STL:IET
ziektewetplannen	ziektewetplan	ZNW:MRV:DE_
leesspelletjes	leesspel	ZNW:MRV:VRK:DE_
leesspellen	leesspel	ZNW:MRV:DE_
zuigworteltjes	zuigwortel	ZNW:MRV:VRK:DE_
zuigwortels	zuigwortel	ZNW:MRV:DE_
pummelige	pummelig	BNW:STL:VRB
uitstootrechten	uitstootrecht	ZNW:MRV:DE_
stukgaande	stukgaand	BNW:STL:VRB
harpuizen	harpuizen	WKW:TGW:INF
harpuis	harpuizen	WKW:TGW:1EP
geharpuisd	harpuizen	WKW:VTD:ONV
vliegvrije	vliegvrij	BNW:STL:VRB
angstloze	angstloos	BNW:STL:VRB
angstloos	angstloos	BNW:STL:IET
angstlozen	angstloos	BNW:STL:MRV:DE_
morenen	moreen	ZNW:MRV:DE_
kussenstoelen	kussenstoel	ZNW:MRV:DE_
gevlerkte	gevlerkt	BNW:STL:VRB
centrumzoekende	centrumzoekend	BNW:STL:VRB
loodsbriefjes	loodsbriefje	ZNW:MRV:VRK:DE_
suikermannetjes	suikermannetje	ZNW:MRV:VRK:DE_
coïncidenten	coïncident	ZNW:MRV:DE_
vroedkundige	vroedkundig	BNW:STL:VRB
spreukachtige	spreukachtig	BNW:STL:VRB
heengesneld	heensnellen	WKW:VTD:ONV
haatsters	haatster	ZNW:MRV:DE_
vitamineloze	vitamineloos	BNW:STL:VRB
vitamineloos	vitamineloos	BNW:STL:IET
nestveren	nestveer	ZNW:MRV:DE_
afvalplanten	afvalplant	ZNW:MRV:DE_
overhemdknoopje	overhemdknoop	ZNW:EKV:VRK:HET
overhemdknoopjes	overhemdknoop	ZNW:MRV:VRK:DE_
paardrij	paardrijden	WKW:TGW:1EP
studio-lp	studio-lp	ZNW:EKV:DE_
studio-lp's	studio-lp	ZNW:MRV:DE_
haltertruitje	haltertrui	ZNW:EKV:VRK:HET
haltertruitjes	haltertrui	ZNW:MRV:VRK:DE_
tepelpompen	tepelpomp	ZNW:MRV:DE_
tepelpompjes	tepelpomp	ZNW:MRV:VRK:DE_
magelhaenganzen	magelhaengans	ZNW:MRV:DE_
visresten	visrest	ZNW:MRV:DE_
visrestjes	visrest	ZNW:MRV:VRK:DE_
vogelresten	vogelrest	ZNW:MRV:DE_
agiotages	agiotage	ZNW:MRV:DE_
peel	peelen	WKW:TGW:1EP
peelde	peelen	WKW:VLT:1EP
gepeeld	peelen	WKW:VTD:ONV
peelt	peelen	WKW:TGW:3EP
peelden	peelen	WKW:VLT:INF
gepeelde	peelen	WKW:VTD:VRB
bloeirijke	bloeirijk	BNW:STL:VRB
bloeirijkste	bloeirijk	BNW:OVR:VRB
bloeirijker	bloeirijk	BNW:VGR:ONV
pimpampet	pimpampetten	WKW:TGW:3EP
plaatsgegrepen	plaatsgrijpen	WKW:VTD:ONV
plaatsgreep	plaatsgrijpen	WKW:VLT:1EP
plaatsgrepen	plaatsgrijpen	WKW:VLT:INF
plaatsgrijpende	plaatsgrijpen	WKW:ODW:VRB
plaatsgrijpt	plaatsgrijpen	WKW:TGW:3EP
plaatsgegrepen	plaatsgrijpen	WKW:VTD:VRB
plant	planten	WKW:TGW:3EP
platslaand	platslaan	WKW:ODW:ONV
platslaande	platslaan	WKW:ODW:VRB
port	porten	WKW:TGW:3EP
prefinancierde	prefinancieren	WKW:VLT:1EP
prefinanciert	prefinancieren	WKW:TGW:3EP
prejudicieerde	prejudiciëren	WKW:VLT:1EP
proefrij	proefrijden	WKW:TGW:1EP
pulpeten	pulpeten	ZNW:MRV:DE_
ongeraden	ongeraden	BNW:STL:VRB
onderschreden	onderschrijden	WKW:VTD:VRB
pluimwild	pluimwild	ZNW:EKV:HET
spuitduur	spuitduur	ZNW:EKV:DE_
vuilbruinen	vuilbruin	BNW:STL:MRV:DE_
wachtleed	wachtleed	ZNW:EKV:HET
hoogpotiger	hoogpotig	BNW:VGR:ONV
beeldloos	beeldloos	BNW:STL:IET
broedloos	broedloos	BNW:STL:IET
lilapaars	lilapaars	BNW:STL:IET
supergaren	supergaar	BNW:STL:MRV:DE_
meterhoger	meterhoog	BNW:VGR:ONV
niet-vasters	niet-vast	BNW:VGR:IET
niet-vasten	niet-vast	BNW:STL:MRV:DE_
kassaloos	kassaloos	BNW:STL:IET
algenrijke	algenrijk	BNW:STL:VRB
breindode	breindood	BNW:STL:VRB
breindoden	breindood	BNW:STL:MRV:DE_
hardgrauwe	hardgrauw	BNW:STL:VRB
ijzerloze	ijzerloos	BNW:STL:VRB
ijzerloos	ijzerloos	BNW:STL:IET
mediavlak	mediavlak	ZNW:EKV:HET
mennoniet	mennoniet	ZNW:EKV:DE_
mennonieten	mennoniet	ZNW:MRV:DE_
stootvrije	stootvrij	BNW:STL:VRB
superfoute	superfout	BNW:STL:VRB
tegelvlak	tegelvlak	ZNW:EKV:HET
tegelvlakken	tegelvlak	ZNW:MRV:DE_
ultravers	ultravers	BNW:STL:IET
shirtloos	shirtloos	BNW:STL:IET
verbruinden	verbruind	BNW:STL:MRV:DE_
draaiweek	draaiweek	ZNW:EKV:DE_
draaiweken	draaiweek	ZNW:MRV:DE_
eenpuntige	eenpuntig	BNW:STL:VRB
eenpuntiger	eenpuntig	BNW:VGR:ONV
feesttip	feesttip	ZNW:EKV:DE_
feesttips	feesttip	ZNW:MRV:DE_
flesgroene	flesgroen	BNW:STL:VRB
godgewijden	godgewijd	BNW:STL:MRV:DE_
kasteloze	kasteloos	BNW:STL:VRB
kasteloos	kasteloos	BNW:STL:IET
kastelozen	kasteloos	BNW:STL:MRV:DE_
pauwblauwe	pauwblauw	BNW:STL:VRB
smaakvrije	smaakvrij	BNW:STL:VRB
anionisch	anionisch	BNW:STL:IET
kaartloos	kaartloos	BNW:STL:IET
kaartlozen	kaartloos	BNW:STL:MRV:DE_
fosforarmer	fosforarm	BNW:VGR:ONV
luchtdop	luchtdop	ZNW:EKV:DE_
luchtdopje	luchtdop	ZNW:EKV:VRK:HET
fluorvrije	fluorvrij	BNW:STL:VRB
zachtlila	zachtlila	BNW:STL:VRB
jungiaans	jungiaans	BNW:STL:IET
ratachtiger	ratachtig	BNW:VGR:ONV
ratachtigen	ratachtig	BNW:STL:MRV:DE_
ratachtige	ratachtige	ZNW:EKV:DE_
ratachtigen	ratachtige	ZNW:MRV:DE_
fenolisch	fenolisch	BNW:STL:IET
eenhokkige	eenhokkig	BNW:STL:VRB
koersloze	koersloos	BNW:STL:VRB
koersloos	koersloos	BNW:STL:IET
kweekduur	kweekduur	ZNW:EKV:DE_
lichtloze	lichtloos	BNW:STL:VRB
lichtloos	lichtloos	BNW:STL:IET
losbolliger	losbollig	BNW:VGR:ONV
paardloos	paardloos	BNW:STL:IET
rijpelijk	rijpelijk	BYW
schubloos	schubloos	BNW:STL:IET
tafelvlak	tafelvlak	ZNW:EKV:HET
tafelvlakken	tafelvlak	ZNW:MRV:DE_
wandlicht	wandlicht	ZNW:EKV:HET
wandlichten	wandlicht	ZNW:MRV:DE_
wandlichtjes	wandlicht	ZNW:MRV:VRK:DE_
wondervoller	wondervol	BNW:VGR:ONV
wondervollen	wondervol	BNW:STL:MRV:DE_
übersexy	übersexy	BNW:STL:VRB
tactmatige	tactmatig	BNW:STL:VRB
halfwinds	halfwinds	BNW:STL:IET
draaivrije	draaivrij	BNW:STL:VRB
actinisch	actinisch	BNW:STL:IET
besachtigen	besachtig	BNW:STL:MRV:DE_
draaglaag	draaglaag	ZNW:EKV:DE_
draaglagen	draaglaag	ZNW:MRV:DE_
glorievolle	glorievol	BNW:STL:VRB
glorievoller	glorievol	BNW:VGR:ONV
gordiaans	gordiaans	BNW:STL:IET
hebbelijker	hebbelijk	BNW:VGR:ONV
kerstslee	kerstslee	ZNW:EKV:DE_
kerstsleeën	kerstslee	ZNW:MRV:DE_
pindavrije	pindavrij	BNW:STL:VRB
sluitdruk	sluitdruk	ZNW:EKV:DE_
startstuk	startstuk	ZNW:EKV:HET
startstukje	startstuk	ZNW:EKV:VRK:HET
startstukken	startstuk	ZNW:MRV:DE_
superdiepe	superdiep	BNW:STL:VRB
tekenvrije	tekenvrij	BNW:STL:VRB
themaloos	themaloos	BNW:STL:IET
vinyllaag	vinyllaag	ZNW:EKV:DE_
vrouwloze	vrouwloos	BNW:STL:VRB
vrouwloos	vrouwloos	BNW:STL:IET
welbereiden	welbereid	BNW:STL:MRV:DE_
drieweeks	drieweeks	BNW:STL:IET
invectieven	invectief	BNW:STL:MRV:DE_
gesnavelden	gesnaveld	BNW:STL:MRV:DE_
obesogener	obesogeen	BNW:VGR:ONV
brandvasten	brandvast	BNW:STL:MRV:DE_
delirisch	delirisch	BNW:STL:IET
adenoïde	adenoïde	BNW:STL:VRB
adenoïden	adenoïde	BNW:STL:MRV:DE_
briefstuk	briefstuk	ZNW:EKV:HET
briefstukje	briefstuk	ZNW:EKV:VRK:HET
briefstukjes	briefstuk	ZNW:MRV:VRK:DE_
briefstukken	briefstuk	ZNW:MRV:DE_
gevaarvolsten	gevaarvol	BNW:OVR:MRV:DE_
grindrijke	grindrijk	BNW:STL:VRB
grindrijker	grindrijk	BNW:VGR:ONV
hemelrond	hemelrond	ZNW:EKV:HET
koelblauwe	koelblauw	BNW:STL:VRB
lampzwart	lampzwart	ZNW:EKV:HET
nertsbont	nertsbont	ZNW:EKV:HET
nevelvrije	nevelvrij	BNW:STL:VRB
prijsvrije	prijsvrij	BNW:STL:VRB
puberleed	puberleed	ZNW:EKV:HET
sterflijken	sterflijk	BNW:STL:MRV:DE_
stijlrijke	stijlrijk	BNW:STL:VRB
stijlrijkste	stijlrijk	BNW:OVR:VRB
stijlrijker	stijlrijk	BNW:VGR:ONV
stijlrijkere	stijlrijk	BNW:VGR:VRB
tweeweeks	tweeweeks	BNW:STL:IET
tweeweekste	tweeweeks	BNW:OVR:VRB
vezeldiepe	vezeldiep	BNW:STL:VRB
vreesloze	vreesloos	BNW:STL:VRB
vreesloos	vreesloos	BNW:STL:IET
zadelloze	zadelloos	BNW:STL:VRB
zadelloos	zadelloos	BNW:STL:IET
zadellozen	zadelloos	BNW:STL:MRV:DE_
spierloos	spierloos	BNW:STL:IET
plotmatige	plotmatig	BNW:STL:VRB
exportras	exportras	ZNW:EKV:HET
exportrassen	exportras	ZNW:MRV:DE_
frisblauwe	frisblauw	BNW:STL:VRB
frontstuk	frontstuk	ZNW:EKV:HET
frontstukken	frontstuk	ZNW:MRV:DE_
gildestuk	gildestuk	ZNW:EKV:HET
goedleers	goedleers	BNW:STL:IET
grondvuil	grondvuil	ZNW:EKV:HET
knotsslak	knotsslak	ZNW:EKV:DE_
knotsslakje	knotsslak	ZNW:EKV:VRK:HET
knotsslakjes	knotsslak	ZNW:MRV:VRK:DE_
knotsslakken	knotsslak	ZNW:MRV:DE_
lastenarmer	lastenarm	BNW:VGR:ONV
luchtloze	luchtloos	BNW:STL:VRB
luchtloos	luchtloos	BNW:STL:IET
nesttrouw	nesttrouw	ZNW:EKV:DE_
rotorvlak	rotorvlak	ZNW:EKV:HET
sekseloos	sekseloos	BNW:STL:IET
slijtvlak	slijtvlak	ZNW:EKV:HET
slijtvlakje	slijtvlak	ZNW:EKV:VRK:HET
slijtvlakjes	slijtvlak	ZNW:MRV:VRK:DE_
slijtvlakken	slijtvlak	ZNW:MRV:DE_
smoorlijk	smoorlijk	BYW
speeldruk	speeldruk	ZNW:EKV:DE_
steekbaren	steekbaar	BNW:STL:MRV:DE_
strafloze	strafloos	BNW:STL:VRB
strafloos	strafloos	BNW:STL:IET
supershot	supershot	ZNW:EKV
supershots	supershot	ZNW:MRV:DE_
zadelstuk	zadelstuk	ZNW:EKV:HET
zadelstukken	zadelstuk	ZNW:MRV:DE_
rondlicht	rondlicht	ZNW:EKV:HET
rondlichten	rondlicht	ZNW:MRV:DE_
landeigen	landeigen	BNW:STL:VRB
krulharigen	krulharig	BNW:STL:MRV:DE_
oosterend	oosterend	ZNW:EKV:HET
klaagvrije	klaagvrij	BNW:STL:VRB
actieloze	actieloos	BNW:STL:VRB
actieloos	actieloos	BNW:STL:IET
actielozer	actieloos	BNW:VGR:ONV
bloedjonge	bloedjong	BNW:STL:VRB
boluslaag	boluslaag	ZNW:EKV:DE_
bomenklem	bomenklem	ZNW:EKV:DE_
mediarijke	mediarijk	BNW:STL:VRB
mediarijker	mediarijk	BNW:VGR:ONV
mediarijkere	mediarijk	BNW:VGR:VRB
breekvlak	breekvlak	ZNW:EKV:HET
breekvlakken	breekvlak	ZNW:MRV:DE_
dwangloos	dwangloos	BNW:STL:IET
fluorzuur	fluorzuur	ZNW:EKV:HET
fransmans	fransman	ZNW:MRV:DE_
kerkbrede	kerkbreed	BNW:STL:VRB
kruisloze	kruisloos	BNW:STL:VRB
kruisloos	kruisloos	BNW:STL:IET
messrooms	messroom	ZNW:MRV:DE_
ongenezen	ongenezen	BNW:STL:VRB
onintegere	oninteger	BNW:STL:VRB
oogvormige	oogvormig	BNW:STL:VRB
plantbaren	plantbaar	BNW:STL:MRV:DE_
vezelloze	vezelloos	BNW:STL:VRB
vezelloos	vezelloos	BNW:STL:IET
vliegtips	vliegtip	ZNW:MRV:DE_
vorstlaag	vorstlaag	ZNW:EKV:DE_
vorstlaagje	vorstlaag	ZNW:EKV:VRK:HET
woordrijke	woordrijk	BNW:STL:VRB
zomerleed	zomerleed	ZNW:EKV:HET
witgeranden	witgerand	BNW:STL:MRV:DE_
parentalen	parentaal	BNW:STL:MRV:DE_
humusloos	humusloos	BNW:STL:IET
brahmaans	brahmaans	BNW:STL:IET
katerloos	katerloos	BNW:STL:IET
turboloos	turboloos	BNW:STL:IET
korstloos	korstloos	BNW:STL:IET
buigstijver	buigstijf	BNW:VGR:ONV
zelotisch	zelotisch	BNW:STL:IET
onwesters	onwesters	BNW:STL:IET
barstvrije	barstvrij	BNW:STL:VRB
werkmatige	werkmatig	BNW:STL:VRB
glansvrije	glansvrij	BNW:STL:VRB
luiervrije	luiervrij	BNW:STL:VRB
kolenvrije	kolenvrij	BNW:STL:VRB
breekstuk	breekstuk	ZNW:EKV:HET
breekstukje	breekstuk	ZNW:EKV:VRK:HET
breekstukken	breekstuk	ZNW:MRV:DE_
combiloos	combiloos	BNW:STL:IET
discogram	discogram	ZNW:EKV:HET
gemijterden	gemijterd	BNW:STL:MRV:DE_
graaflijken	graaflijk	BNW:STL:MRV:DE_
heiderijke	heiderijk	BNW:STL:VRB
hoestvrije	hoestvrij	BNW:STL:VRB
ijdellijk	ijdellijk	BYW
kieuwslak	kieuwslak	ZNW:EKV:DE_
kieuwslakje	kieuwslak	ZNW:EKV:VRK:HET
kieuwslakken	kieuwslak	ZNW:MRV:DE_
koordloos	koordloos	BNW:STL:IET
tienweeks	tienweeks	BNW:STL:IET
freesbare	freesbaar	BNW:STL:VRB
dogachtigen	dogachtig	BNW:STL:MRV:DE_
stokharigen	stokharig	BNW:STL:MRV:DE_
goedogende	goedogend	BNW:STL:VRB
strafvrije	strafvrij	BNW:STL:VRB
dwangvrije	dwangvrij	BNW:STL:VRB
claimvrije	claimvrij	BNW:STL:VRB
plaagvrije	plaagvrij	BNW:STL:VRB
rijstvrije	rijstvrij	BNW:STL:VRB
beginloos	beginloos	BNW:STL:IET
bezetbare	bezetbaar	BNW:STL:VRB
broomzuur	broomzuur	ZNW:EKV:HET
duldeloze	duldeloos	BNW:STL:VRB
duldeloos	duldeloos	BNW:STL:IET
fotoschuwe	fotoschuw	BNW:STL:VRB
onbereikten	onbereikt	BNW:STL:MRV:DE_
onbezaaide	onbezaaid	BNW:STL:VRB
oudachtigen	oudachtig	BNW:STL:MRV:DE_
pokertips	pokertip	ZNW:MRV:DE_
reukeloze	reukeloos	BNW:STL:VRB
reukeloos	reukeloos	BNW:STL:IET
spaanvlak	spaanvlak	ZNW:EKV:HET
spaanvlakken	spaanvlak	ZNW:MRV:DE_
traanloze	traanloos	BNW:STL:VRB
traanloos	traanloos	BNW:STL:IET
vijfledige	vijfledig	BNW:STL:VRB
visumduur	visumduur	ZNW:EKV:DE_
fietsloos	fietsloos	BNW:STL:IET
fietslozen	fietsloos	BNW:STL:MRV:DE_
regenloos	regenloos	BNW:STL:IET
spaanloos	spaanloos	BNW:STL:IET
halfdaags	halfdaags	BNW:STL:IET
blaarvrije	blaarvrij	BNW:STL:VRB
bijenvrije	bijenvrij	BNW:STL:VRB
maïslaag	maïslaag	ZNW:EKV:DE_
kuurmatige	kuurmatig	BNW:STL:VRB
serumvrije	serumvrij	BNW:STL:VRB
dansgragen	dansgraag	BNW:STL:MRV:DE_
tweepotigen	tweepotig	BNW:STL:MRV:DE_
nieuwsluwer	nieuwsluw	BNW:VGR:ONV
videoklem	videoklem	ZNW:EKV:DE_
hagelvrije	hagelvrij	BNW:STL:VRB
enzymvrije	enzymvrij	BNW:STL:VRB
bemanbaar	bemanbaar	BNW:STL:VRB
bergblauwe	bergblauw	BNW:STL:VRB
kijkgragen	kijkgraag	BNW:STL:MRV:DE_
handeloos	handeloos	BNW:STL:IET
hulprecht	hulprecht	ZNW:EKV:HET
hulprechten	hulprecht	ZNW:MRV:DE_
jakobijns	jakobijns	BNW:STL:IET
kaakstomp	kaakstomp	ZNW:EKV:DE_
kaakstompen	kaakstomp	ZNW:MRV:DE_
klierloos	klierloos	BNW:STL:IET
knijpdruk	knijpdruk	ZNW:EKV:DE_
kraaieriger	kraaierig	BNW:VGR:ONV
levitisch	levitisch	BNW:STL:IET
lijwaarts	lijwaarts	BNW:STL:IET
manachtigen	manachtig	BNW:STL:MRV:DE_
notendruk	notendruk	ZNW:EKV:DE_
ogenzwart	ogenzwart	ZNW:EKV:HET
oliebruin	oliebruin	BNW:STL:VRB
ongeplakte	ongeplakt	BNW:STL:VRB
ongeteerde	ongeteerd	BNW:STL:VRB
ophaalnet	ophaalnet	ZNW:EKV:HET
radvormige	radvormig	BNW:STL:VRB
showstop	showstop	ZNW:EKV:DE_
snoepzieke	snoepziek	BNW:STL:VRB
startlaag	startlaag	ZNW:EKV:DE_
veelledige	veelledig	BNW:STL:VRB
vlammerige	vlammerig	BNW:STL:VRB
voettitel	voettitel	ZNW:EKV:DE_
voettitels	voettitel	ZNW:MRV:DE_
vreetbare	vreetbaar	BNW:STL:VRB
wapenruim	wapenruim	ZNW:EKV:HET
wapenruimen	wapenruim	ZNW:MRV:DE_
watertip	watertip	ZNW:EKV:DE_
watertips	watertip	ZNW:MRV:DE_
waterwijze	waterwijs	BNW:STL:VRB
waterwijs	waterwijs	BNW:STL:IET
waterwijzer	waterwijs	BNW:VGR:ONV
waterwijzers	waterwijs	BNW:VGR:IET
lectorale	lectoraal	BNW:STL:VRB
winstloos	winstloos	BNW:STL:IET
boordloos	boordloos	BNW:STL:IET
modelloos	modelloos	BNW:STL:IET
steelloos	steelloos	BNW:STL:IET
ledenloos	ledenloos	BNW:STL:IET
niet-leger	niet-leeg	BNW:VGR:ONV
diëtisch	diëtisch	BNW:STL:IET
voorvorigen	voorvorig	BNW:STL:MRV:DE_
keuzevrije	keuzevrij	BNW:STL:VRB
beeldvrij	beeldvrij	BNW:STL:VRB
meiotisch	meiotisch	BNW:STL:IET
boonranken	boonrank	ZNW:MRV:DE_
angelloos	angelloos	BNW:STL:IET
uilachtigen	uilachtig	BNW:STL:MRV:DE_
werkdadiger	werkdadig	BNW:VGR:ONV
veterloos	veterloos	BNW:STL:IET
zichtloze	zichtloos	BNW:STL:VRB
zichtloos	zichtloos	BNW:STL:IET
sportloos	sportloos	BNW:STL:IET
vachtloos	vachtloos	BNW:STL:IET
spitsloos	spitsloos	BNW:STL:IET
ritmeloos	ritmeloos	BNW:STL:IET
striploos	striploos	BNW:STL:IET
klantloos	klantloos	BNW:STL:IET
tepelloos	tepelloos	BNW:STL:IET
lawaaiarmer	lawaaiarm	BNW:VGR:ONV
levenswijzen	levenswijs	BNW:STL:MRV:DE_
flikkerenden	flikkerend	BNW:STL:MRV:DE_
allerdeplorabelst	deplorabel	BNW:ALR:ONV
glycemisch	glycemisch	BNW:STL:IET
hagelnieuwste	hagelnieuw	BNW:OVR:VRB
prikkelarmer	prikkelarm	BNW:VGR:ONV
prikkelarmere	prikkelarm	BNW:VGR:VRB
scrupuleuzen	scrupuleus	BNW:STL:MRV:DE_
tweewieligen	tweewielig	BNW:STL:MRV:DE_
discontinueren	discontinu	BNW:VGR:MRV:DE_
regressieven	regressief	BNW:STL:MRV:DE_
kleinzerigen	kleinzerig	BNW:STL:MRV:DE_
systolisch	systolisch	BNW:STL:IET
despotischen	despotisch	BNW:STL:MRV:DE_
dystopisch	dystopisch	BNW:STL:IET
dystopischer	dystopisch	BNW:VGR:ONV
blokvormigen	blokvormig	BNW:STL:MRV:DE_
blauwpaars	blauwpaars	BNW:STL:IET
lankmoedigen	lankmoedig	BNW:STL:MRV:DE_
eerzuchtigsten	eerzuchtig	BNW:OVR:MRV:DE_
herderlijken	herderlijk	BNW:STL:MRV:DE_
polychromeren	polychroom	BNW:VGR:MRV:DE_
harsachtigen	harsachtig	BNW:STL:MRV:DE_
hooggehakten	hooggehakt	BNW:STL:MRV:DE_
blauw-gelen	blauw-geel	BNW:STL:MRV:DE_
pejoratiefste	pejoratief	BNW:OVR:VRB
pejoratiever	pejoratief	BNW:VGR:ONV
pejoratievere	pejoratief	BNW:VGR:VRB
pejoratieven	pejoratief	BNW:STL:MRV:DE_
verduivelden	verduiveld	BNW:STL:MRV:DE_
synoptischen	synoptisch	BNW:STL:MRV:DE_
viervoetigere	viervoetig	BNW:VGR:VRB
viervoetigen	viervoetig	BNW:STL:MRV:DE_
groengrijs	groengrijs	BNW:STL:IET
doseerbaren	doseerbaar	BNW:STL:MRV:DE_
kleiachtigen	kleiachtig	BNW:STL:MRV:DE_
beschroomden	beschroomd	BNW:STL:MRV:DE_
geel-blauwen	geel-blauw	BNW:STL:MRV:DE_
kathodisch	kathodisch	BNW:STL:IET
kathodischer	kathodisch	BNW:VGR:ONV
zuilvormigen	zuilvormig	BNW:STL:MRV:DE_
overtalligen	overtallig	BNW:STL:MRV:DE_
rood-blauwen	rood-blauw	BNW:STL:MRV:DE_
welgekozen	welgekozen	BNW:STL:VRB
necrotisch	necrotisch	BNW:STL:IET
eenmotorigen	eenmotorig	BNW:STL:MRV:DE_
zwart-geler	zwart-geel	BNW:VGR:ONV
zwart-gelen	zwart-geel	BNW:STL:MRV:DE_
ongesneden	ongesneden	BNW:STL:VRB
topictitel	topictitel	ZNW:EKV:DE_
topictitels	topictitel	ZNW:MRV:DE_
topictiteltje	topictitel	ZNW:EKV:VRK:HET
francofielen	francofiel	BNW:STL:MRV:DE_
concertant	concertant	ZNW:EKV:DE_
concertanten	concertant	ZNW:MRV:DE_
concertante	concertante	ZNW:EKV:DE_
concertantes	concertante	ZNW:MRV:DE_
dikbetaalden	dikbetaald	BNW:STL:MRV:DE_
laaggradiger	laaggradig	BNW:VGR:ONV
kortlevende	kortlevend	BNW:STL:VRB
kortlevenden	kortlevend	BNW:STL:MRV:DE_
schijterigsten	schijterig	BNW:OVR:MRV:DE_
deficiënten	deficiënt	BNW:STL:MRV:DE_
caritatieven	caritatief	BNW:STL:MRV:DE_
rastypisch	rastypisch	BNW:STL:IET
kankervrije	kankervrij	BNW:STL:VRB
beleidsarmer	beleidsarm	BNW:VGR:ONV
teerachtigen	teerachtig	BNW:STL:MRV:DE_
nachtblauwen	nachtblauw	BNW:STL:MRV:DE_
sprieteriger	sprieterig	BNW:VGR:ONV
editorialen	editoriaal	BNW:STL:MRV:DE_
persuasieven	persuasief	BNW:STL:MRV:DE_
pijlvormigen	pijlvormig	BNW:STL:MRV:DE_
aangezuurde	aangezuurd	BNW:STL:VRB
wijzigbaars	wijzigbaar	BNW:STL:IET
wratachtigen	wratachtig	BNW:STL:MRV:DE_
inhoudloos	inhoudloos	BNW:STL:IET
inhoudlozer	inhoudloos	BNW:VGR:ONV
inhoudlozere	inhoudloos	BNW:VGR:VRB
mousserende	mousserend	BNW:STL:VRB
mousserenden	mousserend	BNW:STL:MRV:DE_
teratogenen	teratogeen	BNW:STL:MRV:DE_
biofysisch	biofysisch	BNW:STL:IET
hoogtoeriger	hoogtoerig	BNW:VGR:ONV
hoogtoerigere	hoogtoerig	BNW:VGR:VRB
synaptisch	synaptisch	BNW:STL:IET
enkellaags	enkellaags	BNW:STL:IET
dionysischen	dionysisch	BNW:STL:MRV:DE_
diuretisch	diuretisch	BNW:STL:IET
lichtbeige	lichtbeige	BNW:STL:VRB
circadiaans	circadiaan	BNW:STL:IET
kindveilige	kindveilig	BNW:STL:VRB
kindveiliger	kindveilig	BNW:VGR:ONV
logistisch	logistisch	BNW:STL:IET
roodoranje	roodoranje	BNW:STL:VRB
onbesneden	onbesneden	BNW:STL:VRB
toegenegen	toegenegen	BNW:STL:VRB
toegenegene	toegenegen	BNW:STL:EKV
poederroze	poederroze	BNW:STL:VRB
middelhardere	middelhard	BNW:VGR:VRB
behagelijken	behagelijk	BNW:STL:MRV:DE_
besdragenden	besdragend	BNW:STL:MRV:DE_
pandemisch	pandemisch	BNW:STL:IET
prosocialer	prosociaal	BNW:VGR:ONV
zwartblauwen	zwartblauw	BNW:STL:MRV:DE_
ongenodigden	ongenodigd	BNW:STL:MRV:DE_
transiënten	transiënt	BNW:STL:MRV:DE_
wormachtigen	wormachtig	BNW:STL:MRV:DE_
kleptomanen	kleptomaan	BNW:STL:MRV:DE_
landwaarts	landwaarts	BNW:STL:IET
soorteigen	soorteigen	BNW:STL:VRB
veenachtigen	veenachtig	BNW:STL:MRV:DE_
ik-gerichter	ik-gericht	BNW:VGR:ONV
knolvormigen	knolvormig	BNW:STL:MRV:DE_
vermiljoen	vermiljoen	BNW:STL:VRB
vermiljoenen	vermiljoenen	BNW:STF
actiematige	actiematig	BNW:STL:VRB
actiematiger	actiematig	BNW:VGR:ONV
ongevouwen	ongevouwen	BNW:STL:VRB
niet-eigen	niet-eigen	BNW:STL:VRB
gelinieerde	gelinieerd	BNW:STL:VRB
voorzienigen	voorzienig	BNW:STL:MRV:DE_
alifatisch	alifatisch	BNW:STL:IET
vochtdichter	vochtdicht	BNW:VGR:ONV
allereerwaardigste	eerwaardig	BNW:ALR:VRB
identitairen	identitair	BNW:STL:MRV:DE_
ongeslepen	ongeslepen	BNW:STL:VRB
grotelijks	grotelijks	BYW
thermofielen	thermofiel	BNW:STL:MRV:DE_
niet-taligen	niet-talig	BNW:STL:MRV:DE_
onafgezien	onafgezien	BYW
verrimpelden	verrimpeld	BNW:STL:MRV:DE_
onbeslagen	onbeslagen	BNW:STL:VRB
pastelroze	pastelroze	BNW:STL:VRB
volbeladen	volbeladen	BNW:STL:VRB
recepissen	recepis	ZNW:MRV:DE_
geradiografeerd	radiograferen	WKW:VTD:ONV
radiografeert	radiograferen	WKW:TGW:3EP
gerebound	rebounden	WKW:VTD:ONV
rebound	rebounden	WKW:TGW:1EP
gerebounde	rebounden	WKW:VTD:VRB
rechtdoe	rechtdoen	WKW:TGW:1EP
rechtgedaan	rechtdoen	WKW:VTD:ONV
rechthou	rechthouden	WKW:TGW:1EP
rechtstel	rechtstellen	WKW:TGW:1EP
rechtstellende	rechtstellen	WKW:ODW:VRB
rechtgesteld	rechtstellen	WKW:VTD:ONV
rechtuitrijden	rechtuitrijden	WKW:TGW:INF
rechtuitrijd	rechtuitrijden	WKW:TGW:1EP
rechtuitrijdend	rechtuitrijden	WKW:ODW:ONV
rechtvaardigend	rechtvaardigen	WKW:ODW:ONV
rondbekken	rondbekken	ZNW:MRV:DE_
rondblaast	rondblazen	WKW:TGW:3EP
rondblazend	rondblazen	WKW:ODW:ONV
rondblies	rondblazen	WKW:VLT:1EP
rondgeblazen	rondblazen	WKW:VTD:ONV
rondgeblazen	rondblazen	WKW:VTD:VRB
rondfluit	rondfluiten	WKW:TGW:1EP
rondfluit	rondfluiten	WKW:TGW:3EP
rondfluitende	rondfluiten	WKW:ODW:VRB
rondgeschuurd	rondschuren	WKW:VTD:ONV
rondgeschuurde	rondschuren	WKW:VTD:VRB
rondschuurt	rondschuren	WKW:TGW:3EP
rondslaand	rondslaan	WKW:ODW:ONV
rondslaande	rondslaan	WKW:ODW:VRB
rondspatte	rondspatten	WKW:VLT:1EP
rondspinnende	rondspinnen	WKW:ODW:VRB
rondspint	rondspinnen	WKW:TGW:3EP
rouwgebruiken	rouwgebruiken	ZNW:MRV:DE_
rugzwemmend	rugzwemmen	WKW:ODW:ONV
rugzwemmende	rugzwemmen	WKW:ODW:VRB
roken	ruiken	WKW:VLT:INF
geroken	ruiken	WKW:VTD:VRB
ruitje	ruit	ZNW:EKV:VRK:HET
ruitjes	ruit	ZNW:MRV:VRK:DE_
kelkvormigen	kelkvormig	BNW:STL:MRV:DE_
ruit	ruiten	WKW:TGW:3EP
groen-roden	groen-rood	BNW:STL:MRV:DE_
zorgenvrijer	zorgenvrij	BNW:VGR:ONV
bladachtigen	bladachtig	BNW:STL:MRV:DE_
periodisch	periodisch	BNW:STL:IET
nachtblinde	nachtblind	BNW:STL:VRB
nachtblinden	nachtblind	BNW:STL:MRV:DE_
omnipotenten	omnipotent	BNW:STL:MRV:DE_
bruinharigen	bruinharig	BNW:STL:MRV:DE_
zandachtigen	zandachtig	BNW:STL:MRV:DE_
mededogender	mededogend	BNW:VGR:ONV
mededogenden	mededogend	BNW:STL:MRV:DE_
smalbandiger	smalbandig	BNW:VGR:ONV
smalbandigere	smalbandig	BNW:VGR:VRB
supertragen	supertraag	BNW:STL:MRV:DE_
machtsgeile	machtsgeil	BNW:STL:VRB
machtsgeiler	machtsgeil	BNW:VGR:ONV
machtsgeilere	machtsgeil	BNW:VGR:VRB
machtsgeilen	machtsgeil	BNW:STL:MRV:DE_
bijdehandst	bijdehands	BNW:OVR:ONV
bijdehands	bijdehands	BNW:STL:IET
bijdehandste	bijdehands	BNW:OVR:VRB
allerbijdehandste	bijdehands	BNW:ALR:VRB
uitgefeeste	uitgefeest	BNW:STL:VRB
wolfachtigen	wolfachtig	BNW:STL:MRV:DE_
buisdefect	buisdefect	ZNW:EKV:HET
buisdefecten	buisdefect	ZNW:MRV:DE_
ponyrijdende	ponyrijden	WKW:ODW:VRB
bierdrinkend	bierdrinken	WKW:ODW:ONV
bierdrinkende	bierdrinken	WKW:ODW:VRB
borstcrawlend	borstcrawlen	WKW:ODW:ONV
bumperend	bumperen	WKW:ODW:ONV
carnavallend	carnavallen	WKW:ODW:ONV
carnavallende	carnavallen	WKW:ODW:VRB
challenge	challengen	WKW:TGW:1EP
challengede	challengen	WKW:VLT:1EP
gechallenged	challengen	WKW:VTD:ONV
challenget	challengen	WKW:TGW:3EP
gechaptaliseerd	chaptaliseren	WKW:VTD:ONV
gechaptaliseerde	chaptaliseren	WKW:VTD:VRB
dropshottend	dropshotten	WKW:ODW:ONV
dubbelziend	dubbelzien	WKW:ODW:ONV
dubbelziende	dubbelzien	WKW:ODW:VRB
geocachend	geocachen	WKW:ODW:ONV
geocachende	geocachen	WKW:ODW:VRB
gitaarspelend	gitaarspelen	WKW:ODW:ONV
gitaarspelende	gitaarspelen	WKW:ODW:VRB
golfsurfend	golfsurfen	WKW:ODW:ONV
golfsurfende	golfsurfen	WKW:ODW:VRB
kickboxend	kickboxen	WKW:ODW:ONV
kickboxende	kickboxen	WKW:ODW:VRB
lapdancend	lapdancen	WKW:ODW:ONV
lapdancende	lapdancen	WKW:ODW:VRB
linedancende	linedancen	WKW:ODW:VRB
medeontwikkel	medeontwikkelen	WKW:TGW:1EP
medeontwikkeld	medeontwikkelen	WKW:VTD:ONV
mentaliserend	mentaliseren	WKW:ODW:ONV
mentaliserende	mentaliseren	WKW:ODW:VRB
overgearticuleerd	overarticuleren	WKW:VTD:ONV
overgearticuleerde	overarticuleren	WKW:VTD:VRB
overbevoorraad	overbevoorraden	WKW:TGW:1EP
overbevoorraad	overbevoorraden	WKW:VTD:ONV
overbevoorraden	overbevoorraden	WKW:VTD:ZNW:MRV:DE_
pinch	pinchen	WKW:TGW:1EP
gepincht	pinchen	WKW:VTD:ONV
rent	renten	WKW:TGW:3EP
fosfaatarmer	fosfaatarm	BNW:VGR:ONV
fosfaatarmere	fosfaatarm	BNW:VGR:VRB
oranje-witten	oranje-wit	BNW:STL:MRV:DE_
hoogzomers	hoogzomers	BNW:STL:IET
laatmodernen	laatmodern	BNW:STL:MRV:DE_
chromatiek	chromatiek	ZNW:EKV:DE_
patricischen	patricisch	BNW:STL:MRV:DE_
rist	risten	WKW:TGW:3EP
oedemateus	oedemateus	BNW:STL:IET
gerist	risten	WKW:VTD:ONV
geriste	risten	WKW:VTD:VRB
levensloze	levensloos	BNW:STL:VRB
levensloos	levensloos	BNW:STL:IET
levenslozer	levensloos	BNW:VGR:ONV
ongeblazen	ongeblazen	BNW:STL:VRB
schizoïde	schizoïde	BNW:STL:VRB
doortekender	doortekend	BNW:VGR:ONV
roadtrippend	roadtrippen	WKW:ODW:ONV
bleekbruine	bleekbruin	BNW:STL:VRB
regendichte	regendicht	BNW:STL:VRB
postactieven	postactief	BNW:STL:MRV:DE_
filmachtiger	filmachtig	BNW:VGR:ONV
superdrogen	superdroog	BNW:STL:MRV:DE_
roest	roezen	WKW:TGW:3EP
reconditionerende	reconditioneren	WKW:ODW:VRB
reconditioneer	reconditioneren	WKW:TGW:1EP
gereconditioneerd	reconditioneren	WKW:VTD:ONV
reconditioneert	reconditioneren	WKW:TGW:3EP
gereconditioneerde	reconditioneren	WKW:VTD:VRB
recover	recoveren	WKW:TGW:1EP
recoverde	recoveren	WKW:VLT:1EP
gerecoverd	recoveren	WKW:VTD:ONV
recovert	recoveren	WKW:TGW:3EP
recoverden	recoveren	WKW:VLT:INF
gerecoverde	recoveren	WKW:VTD:VRB
recruit	recruiten	WKW:TGW:1EP
gerecruit	recruiten	WKW:VTD:ONV
recruit	recruiten	WKW:TGW:3EP
recruitten	recruiten	WKW:VLT:INF
relayeert	relayeren	WKW:TGW:3EP
relschoppend	relschoppen	WKW:ODW:ONV
relschoppende	relschoppen	WKW:ODW:VRB
geremde	remmen	WKW:VTD:VRB
superbraven	superbraaf	BNW:STL:MRV:DE_
sneeuwrijke	sneeuwrijk	BNW:OVR:VRB
sneeuwrijke	sneeuwrijk	BNW:STL:VRB
sneeuwrijker	sneeuwrijk	BNW:VGR:ONV
sneeuwrijkere	sneeuwrijk	BNW:VGR:VRB
doorgaand	doorgaand	BNW:STL:ONV
doorgaande	doorgaand	BNW:STL:VRB
doorgaands	doorgaand	BNW:STL:IET
doorgaanden	doorgaand	BNW:STL:MRV:DE_
eendachtigen	eendachtig	BNW:STL:MRV:DE_
nageeflijker	nageeflijk	BNW:VGR:ONV
aangegeten	aangegeten	BNW:STL:VRB
samengedaan	samendoen	WKW:VTD:ONV
tart	tarren	WKW:TGW:3EP
zonden	zonnen	WKW:VLT:INF
tegenvoets	tegenvoets	BYW
bedenkbaren	bedenkbaar	BNW:STL:MRV:DE_
tweedraads	tweedraads	BNW:STL:IET
epifytisch	epifytisch	BNW:STL:IET
alchemisch	alchemisch	BNW:STL:IET
boomachtigen	boomachtig	BNW:STL:MRV:DE_
tomaatroden	tomaatrood	BNW:STL:MRV:DE_
gepenseelde	gepenseeld	BNW:STL:VRB
karnemelks	karnemelks	BNW:STL:IET
vingerloos	vingerloos	BNW:STL:IET
lenteklare	lenteklaar	BNW:STL:VRB
strooibaars	strooibaar	BNW:STL:IET
strooibaarder	strooibaar	BNW:VGR:ONV
accusatieve	accusatief	BNW:STL:VRB
accusatief	accusatief	ZNW:EKV:DE_
accusatieven	accusatief	ZNW:MRV:DE_
episcopaals	episcopaal	BNW:STL:IET
veelkantiger	veelkantig	BNW:VGR:ONV
niet-joodse	niet-joods	BNW:STL:VRB
niet-joods	niet-joods	BNW:STL:IET
kationisch	kationisch	BNW:STL:IET
laagtoeriger	laagtoerig	BNW:VGR:ONV
laagtoerigere	laagtoerig	BNW:VGR:VRB
oliegevulder	oliegevuld	BNW:VGR:ONV
ongespoten	ongespoten	BNW:STL:VRB
ferritisch	ferritisch	BNW:STL:IET
roodbladigen	roodbladig	BNW:STL:MRV:DE_
bovenplans	bovenplans	BNW:STL:IET
halachisch	halachisch	BNW:STL:IET
puntenloze	puntenloos	BNW:STL:VRB
puntenloos	puntenloos	BNW:STL:IET
puntenlozen	puntenloos	BNW:STL:MRV:DE_
geluidsluwer	geluidsluw	BNW:VGR:ONV
schakelluier	schakellui	BNW:VGR:ONV
snelvoetigen	snelvoetig	BNW:STL:MRV:DE_
energievolle	energievol	BNW:STL:VRB
energievoller	energievol	BNW:VGR:ONV
oranjeroze	oranjeroze	BNW:STL:VRB
isotonisch	isotonisch	BNW:STL:IET
knopvormigen	knopvormig	BNW:STL:MRV:DE_
volkseigen	volkseigen	BNW:STL:VRB
volkseigener	volkseigen	BNW:VGR:ONV
volkseigene	volkseigen	BNW:STL:EKV
welgelegen	welgelegen	BNW:STL:VRB
welgelegene	welgelegen	BNW:STL:EKV
tochtdichter	tochtdicht	BNW:VGR:ONV
calamiteus	calamiteus	BNW:STL:IET
rondbuikigen	rondbuikig	BNW:STL:MRV:DE_
supervroeger	supervroeg	BNW:VGR:ONV
tintelfris	tintelfris	BNW:STL:IET
meerwandigen	meerwandig	BNW:STL:MRV:DE_
antizwarte	antizwart	BNW:STL:VRB
suikerloze	suikerloos	BNW:STL:VRB
suikerloos	suikerloos	BNW:STL:IET
suikerlozen	suikerloos	BNW:STL:MRV:DE_
zoetachtigen	zoetachtig	BNW:STL:MRV:DE_
dieporanje	dieporanje	BNW:STL:VRB
geel-grijs	geel-grijs	BNW:STL:IET
helderroze	helderroze	BNW:STL:VRB
atechnisch	atechnisch	BNW:STL:IET
connectieven	connectief	BNW:STL:MRV:DE_
vuilgebekter	vuilgebekt	BNW:VGR:ONV
blijgezinder	blijgezind	BNW:VGR:ONV
deïstisch	deïstisch	BNW:STL:IET
ignatiaans	ignatiaans	BNW:STL:IET
gebenedijden	gebenedijd	BNW:STL:MRV:DE_
plantklare	plantklaar	BNW:STL:VRB
tweevoetigen	tweevoetig	BNW:STL:MRV:DE_
werkgevenden	werkgevend	BNW:STL:MRV:DE_
respirabele	respirabel	BNW:STL:VRB
zwemveiliger	zwemveilig	BNW:VGR:ONV
fibrotisch	fibrotisch	BNW:STL:IET
fibrotischer	fibrotisch	BNW:VGR:ONV
aandewinds	aandewinds	BNW:STL:IET
betongrijs	betongrijs	BNW:STL:IET
alleenlijk	alleenlijk	BYW
jeansblauwe	jeansblauw	BNW:STL:VRB
rietachtigen	rietachtig	BNW:STL:MRV:DE_
sneeuwgans	sneeuwgans	ZNW:EKV:DE_
sneeuwganzen	sneeuwgans	ZNW:MRV:DE_
woordblinde	woordblind	BNW:STL:VRB
woordblinden	woordblind	BNW:STL:MRV:DE_
onbegraven	onbegraven	BNW:STL:VRB
onbegravene	onbegraven	BNW:STL:EKV
combattiefst	combattief	BNW:OVR:ONV
combattiever	combattief	BNW:VGR:ONV
ongedroogden	ongedroogd	BNW:STL:MRV:DE_
steengrijs	steengrijs	BNW:STL:IET
duifachtigen	duifachtig	BNW:STL:MRV:DE_
onbeslapen	onbeslapen	BNW:STL:VRB
bleekgrijs	bleekgrijs	BNW:STL:IET
ijzergrauwen	ijzergrauw	BNW:STL:MRV:DE_
genocidairen	genocidair	BNW:STL:MRV:DE_
heterofielen	heterofiel	BNW:STL:MRV:DE_
premorbide	premorbide	BNW:STL:VRB
niet-links	niet-links	BNW:STL:IET
niet-linksen	niet-links	BNW:STL:MRV:DE_
boekachtigen	boekachtig	BNW:STL:MRV:DE_
chroomvrije	chroomvrij	BNW:STL:VRB
uitgedanste	uitgedanst	BNW:STL:VRB
reologisch	reologisch	BNW:STL:IET
vinkachtigen	vinkachtig	BNW:STL:MRV:DE_
driedraads	driedraads	BNW:STL:IET
slierteriger	slierterig	BNW:VGR:ONV
allweather	allweather	BNW:STL:VRB
inhoudsvolle	inhoudsvol	BNW:STL:VRB
inhoudsvoller	inhoudsvol	BNW:VGR:ONV
inhoudsvollere	inhoudsvol	BNW:VGR:VRB
limietloos	limietloos	BNW:STL:IET
reciproque	reciproque	BNW:STL:VRB
rotkreupel	rotkreupel	ZNW:EKV:HET
wijnachtigen	wijnachtig	BNW:STL:MRV:DE_
zomerproof	zomerproof	BNW:STL:VRB
purperroze	purperroze	BNW:STL:VRB
museumweek	museumweek	ZNW:EKV:DE_
museumweken	museumweek	ZNW:MRV:DE_
onverkozen	onverkozen	BNW:STL:VRB
opzeggrond	opzeggrond	ZNW:EKV:DE_
opzeggronden	opzeggrond	ZNW:MRV:DE_
heksachtiger	heksachtig	BNW:VGR:ONV
blondharigen	blondharig	BNW:STL:MRV:DE_
rockachtiger	rockachtig	BNW:VGR:ONV
zalmachtigen	zalmachtig	BNW:STL:MRV:DE_
listiglijk	listiglijk	BYW
ongeholpen	ongeholpen	BNW:STL:VRB
isotopisch	isotopisch	BNW:STL:IET
reuzetrots	reuzetrots	BNW:STL:IET
diepveneus	diepveneus	BNW:STL:IET
lutheraans	lutheraans	BNW:STL:IET
niet-zwarten	niet-zwart	BNW:STL:MRV:DE_
godgegeven	godgegeven	BNW:STL:VRB
gootvormigen	gootvormig	BNW:STL:MRV:DE_
moddervrije	moddervrij	BNW:STL:VRB
naaktzadigen	naaktzadig	BNW:STL:MRV:DE_
onbezongen	onbezongen	BNW:STL:VRB
knolachtigen	knolachtig	BNW:STL:MRV:DE_
effectloos	effectloos	BNW:STL:IET
entropisch	entropisch	BNW:STL:IET
dactylisch	dactylisch	BNW:STL:IET
draadharigen	draadharig	BNW:STL:MRV:DE_
versjteerden	versjteerd	BNW:STL:MRV:DE_
welgeboren	welgeboren	BNW:STL:VRB
stekelloos	stekelloos	BNW:STL:IET
muntachtigen	muntachtig	BNW:STL:MRV:DE_
onbevroren	onbevroren	BNW:STL:VRB
planteigen	planteigen	BNW:STL:VRB
stresseriger	stresserig	BNW:VGR:ONV
wit-oranje	wit-oranje	BNW:STL:VRB
basaltisch	basaltisch	BNW:STL:IET
panoptisch	panoptisch	BNW:STL:IET
cementloos	cementloos	BNW:STL:IET
kozijnloos	kozijnloos	BNW:STL:IET
niveauloos	niveauloos	BNW:STL:IET
serverfout	serverfout	ZNW:EKV:DE_
serverfouten	serverfout	ZNW:MRV:DE_
vruchtdood	vruchtdood	ZNW:EKV:DE_
loefgieriger	loefgierig	BNW:VGR:ONV
rupsachtigen	rupsachtig	BNW:STL:MRV:DE_
zwartpaars	zwartpaars	BNW:STL:IET
quotumloos	quotumloos	BNW:STL:IET
beigebruine	beigebruin	BNW:STL:VRB
waardedruk	waardedruk	ZNW:EKV:DE_
onverbogen	onverbogen	BNW:STL:VRB
muisachtigen	muisachtig	BNW:STL:MRV:DE_
schuurvaster	schuurvast	BNW:VGR:ONV
versbakken	versbakken	BNW:STL:VRB
ezelachtigen	ezelachtig	BNW:STL:MRV:DE_
onverenigden	onverenigd	BNW:STL:MRV:DE_
islamofielen	islamofiel	BNW:STL:MRV:DE_
adviesvrije	adviesvrij	BNW:STL:VRB
fraudevrije	fraudevrij	BNW:STL:VRB
grijsbeige	grijsbeige	BNW:STL:VRB
kaliumrijk	kaliumrijk	BNW:STL:VRB
luizenvrije	luizenvrij	BNW:STL:VRB
onbestuurder	onbestuurd	BNW:VGR:ONV
schaalloos	schaalloos	BNW:STL:IET
saprotrofen	saprotroof	BNW:STL:MRV:DE_
nucleofielen	nucleofiel	BNW:STL:MRV:DE_
residuvrije	residuvrij	BNW:STL:VRB
koperbruine	koperbruin	BNW:STL:VRB
krachtloze	krachtloos	BNW:STL:VRB
winkeltip	winkeltip	ZNW:EKV:DE_
winkeltips	winkeltip	ZNW:MRV:DE_
leiderloos	leiderloos	BNW:STL:IET
leiderloze	leiderloos	BNW:STL:VRB
leiderlozer	leiderloos	BNW:VGR:ONV
muggenvrije	muggenvrij	BNW:STL:VRB
paars-gelen	paars-geel	BNW:STL:MRV:DE_
samenzwoeren	samenzweren	WKW:VLT:INF
stat	statten	WKW:TGW:3EP
teruggeleid	teruggeleiden	WKW:VTD:ONV
teruggeleide	teruggeleiden	WKW:VTD:VRB
teruggeleiden	teruggeleiden	WKW:VTD:ZNW:MRV:DE_
toegedaan	toedoen	WKW:VTD:ONV
toegedane	toedoen	WKW:VTD:VRB
toetast	toetasten	WKW:TGW:3EP
tuit	tuiten	WKW:TGW:3EP
twijfelende	twijfelen	WKW:ODW:VRB
uitplant	uitplannen	WKW:TGW:3EP
uitzwierven	uitzwerven	WKW:VLT:INF
vastzette	vastzetten	WKW:VLT:1EP
verblijd	verblijen	WKW:VTD:ONV
verblijde	verblijen	WKW:VTD:VRB
verblijden	verblijen	WKW:VTD:ZNW:MRV:DE_
verbrachten	verbrengen	WKW:VLT:INF
aangedreven	aandrijven	WKW:VTD:VRB
aangekozen	aankiezen	WKW:VTD:VRB
gekorven	kerven	WKW:VTD:VRB
geplozen	pluizen	WKW:VTD:VRB
geprezen	prijzen	WKW:VTD:VRB
doorvaren	doorvaren	WKW:VTD:VRB
beerachtige	beerachtig	BNW:STL:VRB
beerachtigen	beerachtig	BNW:STL:MRV:DE_
geldgierigen	geldgierig	BNW:STL:MRV:DE_
gesjochten	gesjochten	BNW:STL:VRB
inktachtigen	inktachtig	BNW:STL:MRV:DE_
vierdraads	vierdraads	BNW:STL:IET
wereldronde	wereldrond	BNW:STL:VRB
verheven	verheffen	WKW:VTD:ONV
verheven	verheffen	WKW:VTD:VRB
verklonken	verklinken	WKW:VLT:INF
verliederlijkt	verliederlijkt	BNW:STL:ONV
verliederlijkte	verliederlijkt	BNW:STL:VRB
verspoten	verspuiten	WKW:VLT:INF
vervatten	vervatten	WKW:VLT:1EP
vetmest	vetmesten	WKW:TGW:3EP
vilt	vilten	WKW:TGW:3EP
volplant	volplanten	WKW:TGW:3EP
volspuit	volspuiten	WKW:TGW:3EP
voorbijschoven	voorbijschuiven	WKW:VLT:INF
voorgeleid	voorleiden	WKW:VTD:ONV
voorgeleide	voorleiden	WKW:VTD:VRB
voorgeleiden	voorleiden	WKW:VTD:ZNW:MRV:DE_
voortgeleid	voortgeleiden	WKW:VTD:ONV
voortgeleide	voortgeleiden	WKW:VTD:VRB
vooruitziende	vooruitzien	WKW:ODW:VRB
geziene	zien	WKW:VTD:VRB
weggeraakt	weggeraken	WKW:VTD:ONV
weggeraakte	weggeraken	WKW:VTD:VRB
wegrace	wegracen	WKW:TGW:1EP
welgelukt	welgelukken	WKW:VTD:ONV
welgelukte	welgelukken	WKW:VTD:VRB
welgeslaagd	welgeslaagd	BNW:STL:ONV
welgeslaagde	welgeslaagd	BNW:STL:VRB
geweten	wijten	WKW:VTD:ONV
gewetene	wijten	WKW:VTD:ZNW:EKV
geweten	wijten	WKW:VTD:VRB
wisten	wissen	WKW:VLT:INF
sanctieplaatsen	sanctieplaatsen	ZNW:MRV:DE_
sausflessen	sausflessen	ZNW:MRV:DE_
schaduwvlekken	schaduwvlekken	ZNW:MRV:DE_
schijngrenzen	schijngrenzen	ZNW:MRV:DE_
pindarische	pindarisch	BNW:STL:VRB
onverwelkte	onverwelkt	BNW:STL:VRB
chemieloos	chemieloos	BNW:STL:IET
ontrefbare	ontrefbaar	BNW:STL:VRB
kropachtige	kropachtig	BNW:STL:VRB
onverheelde	onverheeld	BNW:STL:VRB
kristallige	kristallig	BNW:STL:VRB
baksgewijze	baksgewijs	BNW:STL:VRB
baksgewijs	baksgewijs	BNW:STL:IET
witkleurige	witkleurig	BNW:STL:VRB
loefwaarts	loefwaarts	BNW:STL:IET
ruimteloze	ruimteloos	BNW:STL:VRB
ruimteloos	ruimteloos	BNW:STL:IET
seksbeesten	seksbeesten	ZNW:MRV:DE_
geslagen	slaan	WKW:VTD:VRB
schrijfstraffen	schrijfstraffen	ZNW:MRV:DE_
schouderpunten	schouderpunten	ZNW:MRV:DE_
wijkkaarten	wijkkaarten	ZNW:MRV:DE_
vormsporen	vormsporen	ZNW:MRV:DE_
vlasbollen	vlasbollen	ZNW:MRV:DE_
sequenceten	sequencen	WKW:VLT:INF
target	targetten	WKW:TGW:3EP
targetten	targetten	WKW:VLT:INF
troubleshoot	troubleshooten	WKW:TGW:3EP
vaat	vaten	WKW:TGW:3EP
videochat	videochatten	WKW:TGW:3EP
videochatten	videochatten	WKW:VLT:INF
wedervarende	wedervaren	WKW:ODW:VRB
wedervaart	wedervaren	WKW:TGW:3EP
gezworen	zweren	WKW:VTD:VRB
ingezworen	inzweren	WKW:VTD:VRB
verzwoer	verzweren	WKW:VLT:1EP
inzwoer	inzweren	WKW:VLT:1EP
inzwoeren	inzweren	WKW:VLT:INF
stuwzakken	stuwzakken	ZNW:MRV:DE_
supportersrellen	supportersrellen	ZNW:MRV:DE_
tandt	tanden	WKW:TGW:3EP
tandde	tanden	WKW:VLT:1EP
tandden	tanden	WKW:VLT:INF
targette	targeten	WKW:VLT:1EP
targetten	targeten	WKW:VLT:INF
target	targeten	WKW:TGW:1EP
target	targeten	WKW:TGW:3EP
getarget	targeten	WKW:VTD:ONV
getargete	targeten	WKW:VTD:VRB
anolissen	anolis	ZNW:MRV:DE_
zaagresten	zaagresten	ZNW:MRV:DE_
zaalhockeyend	zaalhockeyen	WKW:ODW:ONV
gezaalhockeyd	zaalhockeyen	WKW:VTD:ONV
gezakkenrold	zakkenrollen	WKW:VTD:ONV
zakgelopen	zaklopen	WKW:VTD:ONV
zeepstoffen	zeepstoffen	ZNW:MRV:DE_
zeevaren	zeevaren	WKW:INF:ZNW:HET
zoekplaatsen	zoekplaatsen	ZNW:MRV:DE_
zoekprenten	zoekprenten	ZNW:MRV:DE_
zoekuren	zoekuren	ZNW:MRV:DE_
zoekwensen	zoekwensen	ZNW:MRV:DE_
zoom	zoomen	WKW:TGW:1EP
zoomde	zoomen	WKW:VLT:1EP
gezoomd	zoomen	WKW:VTD:ONV
zoomt	zoomen	WKW:TGW:3EP
zoomden	zoomen	WKW:VLT:INF
zorgdoelen	zorgdoelen	ZNW:MRV:DE_
zuipschuren	zuipschuren	ZNW:MRV:DE_
zwaailappen	zwaailappen	ZNW:MRV:DE_
zwartjassen	zwartjassen	ZNW:MRV:DE_
wattenrollen	wattenrollen	ZNW:MRV:DE_
weekkoersen	weekkoersen	ZNW:MRV:DE_
wenkkrabben	wenkkrabben	ZNW:MRV:DE_
woonwaren	woonwaren	ZNW:MRV:DE_
wisseldelen	wisseldelen	ZNW:MRV:DE_
wandwerken	wandwerken	ZNW:MRV:DE_
weerhoudenen	weerhouden	WKW:VTD:ZNW:MRV:DE_
weggefrommelde	wegfrommelen	WKW:VTD:VRB
weghou	weghouden	WKW:TGW:1EP
weggekiept	wegkiepen	WKW:VTD:ONV
wegkiept	wegkiepen	WKW:TGW:3EP
weggekiepte	wegkiepen	WKW:VTD:VRB
weggeklikte	wegklikken	WKW:VTD:VRB
weggekrabde	wegkrabben	WKW:VTD:VRB
weggesodemieterd	wegsodemieteren	WKW:VTD:ONV
wegsodemieter	wegsodemieteren	WKW:TGW:1EP
wegsodemietert	wegsodemieteren	WKW:TGW:3EP
gestoten	stoten	WKW:VTD:VRB
weggetakelde	wegtakelen	WKW:VTD:VRB
welgedane	weldoen	WKW:VTD:VRB
superbruiner	superbruin	BNW:VGR:ONV
taalbewuster	taalbewust	BNW:VGR:ONV
toebemeten	toebemeten	BNW:STL:VRB
tuinvriendje	tuinvriend	ZNW:EKV:VRK:HET
tuinvriendjes	tuinvriend	ZNW:MRV:VRK:DE_
vriendloos	vriendloos	BNW:STL:IET
expiratoire	expiratoir	BNW:STL:VRB
sensorloos	sensorloos	BNW:STL:IET
anionogenen	anionogeen	BNW:STL:MRV:DE_
wildkamperend	wildkamperen	WKW:ODW:ONV
wildkamperende	wildkamperen	WKW:ODW:VRB
buike	uitbuiken	WKW:AWS:LOS
buit	uitbuiten	WKW:TGW:3EP:LOS
burgeren	uitburgeren	WKW:TGW:INF:LOS
burger	uitburgeren	WKW:TGW:1EP:LOS
burgerde	uitburgeren	WKW:VLT:1EP:LOS
burgert	uitburgeren	WKW:TGW:3EP:LOS
burgerden	uitburgeren	WKW:VLT:INF:LOS
burgere	uitburgeren	WKW:AWS:LOS
montere	opmonteren	WKW:AWS:LOS
monteren	opmonteren	WKW:TGW:INF:LOS
rondgepasst	rondpassen	WKW:VTD:ONV
ponden	uitponden	WKW:TGW:INF:LOS
uitgepond	uitponden	WKW:VTD:ONV
uitpond	uitponden	WKW:TGW:1EP
pond	uitponden	WKW:TGW:1EP:LOS
pondt	uitponden	WKW:TGW:3EP:LOS
uitgeponde	uitponden	WKW:VTD:VRB
rande	aanranden	WKW:AWS:LOS
regent	neerregenen	WKW:TGW:3EP:LOS
regende	neerregenen	WKW:VLT:1EP:LOS
regenden	neerregenen	WKW:VLT:INF:LOS
regenen	neerregenen	WKW:TGW:INF:LOS
regene	neerregenen	WKW:AWS:LOS
regene	wegregenen	WKW:AWS:LOS
regent	wegregenen	WKW:TGW:3EP:LOS
regende	wegregenen	WKW:VLT:1EP:LOS
regenden	wegregenen	WKW:VLT:INF:LOS
regenen	wegregenen	WKW:TGW:INF:LOS
regene	natregenen	WKW:AWS:LOS
regen	natregenen	WKW:TGW:1EP:LOS
regent	natregenen	WKW:TGW:3EP:LOS
regenen	natregenen	WKW:TGW:INF:LOS
regende	natregenen	WKW:VLT:1EP:LOS
regenden	natregenen	WKW:VLT:INF:LOS
zwakke	afzwakken	WKW:AWS:LOS
aangerijpte	aangerijpt	BNW:STL:VRB
aanlegvlak	aanlegvlak	ZNW:EKV:HET
aanlegvlakken	aanlegvlak	ZNW:MRV:DE_
spaarmunten	spaarmunten	ZNW:MRV:DE_
bruinbeige	bruinbeige	BNW:STL:VRB
snuffellessen	snuffellessen	ZNW:MRV:DE_
sneeuwhopen	sneeuwhopen	ZNW:MRV:DE_
klachtvrije	klachtvrij	BNW:STL:VRB
slijtdelen	slijtdelen	ZNW:MRV:DE_
sierstrepen	sierstrepen	ZNW:MRV:DE_
uitgepoetste	uitpoetsen	WKW:VTD:VRB
uitgepuzzelde	uitpuzzelen	WKW:VTD:VRB
uitscheet	uitscheiden	WKW:VLT:GIJ
scheidde	uitscheiden	WKW:VLT:1EP:LOS
uitscheden	uitscheiden	WKW:VLT:INF
scheidden	uitscheiden	WKW:VLT:INF:LOS
scheden	uitscheiden	WKW:VLT:INF:LOS
uitgescheiden	uitscheiden	WKW:VTD:VRB
uitgescheden	uitscheiden	WKW:VTD:VRB
scheiden	uitscheiden	WKW:TGW:INF:LOS
scheidt	uitscheiden	WKW:TGW:3EP:LOS
scheid	uitscheiden	WKW:TGW:1EP:LOS
schei	uitscheiden	WKW:TGW:1EP:LOS
scheide	uitscheiden	WKW:AWS:LOS
objectloos	objectloos	BNW:STL:IET
ongewroken	ongewroken	BNW:STL:VRB
schuimloos	schuimloos	BNW:STL:IET
uitvalduur	uitvalduur	ZNW:EKV:DE_
schermloos	schermloos	BNW:STL:IET
kleinmazigste	kleinmazig	BNW:OVR:VRB
druïdisch	druïdisch	BNW:STL:IET
leukemisch	leukemisch	BNW:STL:IET
aardebruine	aardebruin	BNW:STL:VRB
drukgerede	drukgereed	BNW:STL:VRB
foutenvrije	foutenvrij	BNW:STL:VRB
moraalloos	moraalloos	BNW:STL:IET
moraallozer	moraalloos	BNW:VGR:ONV
verjaagde	verjagen	WKW:VLT:1EP
verjaagden	verjagen	WKW:VLT:INF
paarbladige	paarbladig	BNW:STL:VRB
prijsmatige	prijsmatig	BNW:STL:VRB
vestbrieven	vestbrieven	ZNW:MRV:DE_
visscholen	visscholen	ZNW:MRV:DE_
voodoopraktijken	voodoopraktijken	ZNW:MRV:DE_
vastdagen	vastdagen	ZNW:MRV:DE_
vaaspoten	vaaspoten	ZNW:MRV:DE_
vaartdagen	vaartdagen	ZNW:MRV:DE_
tekeer	tekeer	BYW
teweer	teweer	BYW
tewerk	tewerk	BYW
weder	weder	BYW
neder	neder	BYW
saus	sauzen	WKW:TGW:1EP
saust	sauzen	WKW:TGW:3EP
geschapene	scheppen	WKW:VTD:ZNW:EKV
geschapenen	scheppen	WKW:VTD:ZNW:MRV:DE_
schoonhou	schoonhouden	WKW:TGW:1EP
schoongepoetste	schoonpoetsen	WKW:VTD:VRB
schoongespoelde	schoonspoelen	WKW:VTD:VRB
slakachtigen	slakachtig	BNW:STL:MRV:DE_
sproeistuk	sproeistuk	ZNW:EKV:HET
sproeistukken	sproeistuk	ZNW:MRV:DE_
taakbewuste	taakbewust	BNW:STL:VRB
taakbewuster	taakbewust	BNW:VGR:ONV
geldbewuster	geldbewust	BNW:VGR:ONV
neoromaans	neoromaans	BNW:STL:IET
doorbraden	doorbraden	BNW:STL:VRB
chroomgele	chroomgeel	BNW:STL:VRB
kroesharigen	kroesharig	BNW:STL:MRV:DE_
maskerlaag	maskerlaag	ZNW:EKV:DE_
maskerlaagje	maskerlaag	ZNW:EKV:VRK:HET
maskerlagen	maskerlaag	ZNW:MRV:DE_
ongehoornde	ongehoornd	BNW:STL:VRB
nummerloos	nummerloos	BNW:STL:IET
handgeleider	handgeleid	BNW:VGR:ONV
eczemateus	eczemateus	BNW:STL:IET
euritmisch	euritmisch	BNW:STL:IET
ambergrijze	ambergrijs	BNW:STL:VRB
ambergrijs	ambergrijs	BNW:STL:IET
bladerrijke	bladerrijk	BNW:STL:VRB
canadagans	canadagans	ZNW:EKV:DE_
canadaganzen	canadagans	ZNW:MRV:DE_
grafwaarts	grafwaarts	BNW:STL:IET
grootmazige	grootmazig	BNW:STL:VRB
korrellaag	korrellaag	ZNW:EKV:DE_
levensleed	levensleed	ZNW:EKV:HET
liervormige	liervormig	BNW:STL:VRB
mesttekort	mesttekort	ZNW:EKV:HET
mesttekorten	mesttekort	ZNW:MRV:DE_
middellage	middellaag	BNW:STL:VRB
middellagen	middellaag	BNW:STL:MRV:DE_
procesdruk	procesdruk	ZNW:EKV:DE_
procesdrukken	procesdruk	ZNW:MRV:DE_
recordlage	recordlaag	BNW:STL:VRB
schuifvlak	schuifvlak	ZNW:EKV:HET
schuifvlakken	schuifvlak	ZNW:MRV:DE_
sensorvlak	sensorvlak	ZNW:EKV:HET
sensorvlakken	sensorvlak	ZNW:MRV:DE_
tussendeks	tussendeks	BNW:STL:IET
volstandigen	volstandig	BNW:STL:MRV:DE_
wonderzoete	wonderzoet	BNW:STL:VRB
barbieroze	barbieroze	BNW:STL:VRB
blauw-roze	blauw-roze	BNW:STL:VRB
hondachtige	hondachtig	BNW:STL:VRB
hondachtigen	hondachtig	BNW:STL:MRV:DE_
onduidbaarder	onduidbaar	BNW:VGR:ONV
filtertip	filtertip	ZNW:EKV:DE_
filtertips	filtertip	ZNW:MRV:DE_
geneeslijker	geneeslijk	BNW:VGR:ONV
gordelloze	gordelloos	BNW:STL:VRB
gordelloos	gordelloos	BNW:STL:IET
heuvelrijke	heuvelrijk	BNW:STL:VRB
heuvelrijker	heuvelrijk	BNW:VGR:ONV
mediaschuwe	mediaschuw	BNW:STL:VRB
onbevlogen	onbevlogen	BNW:STL:VRB
papiervrije	papiervrij	BNW:STL:VRB
plaatsloze	plaatsloos	BNW:STL:VRB
plaatsloos	plaatsloos	BNW:STL:IET
pornoblonde	pornoblond	BNW:STL:VRB
sectorvlak	sectorvlak	ZNW:EKV:HET
sluitlicht	sluitlicht	ZNW:EKV:HET
sluitlichten	sluitlicht	ZNW:MRV:DE_
zwavelrijke	zwavelrijk	BNW:STL:VRB
zwavelrijker	zwavelrijk	BNW:VGR:ONV
zwavelrijkere	zwavelrijk	BNW:VGR:VRB
etiketloos	etiketloos	BNW:STL:IET
spilvormigen	spilvormig	BNW:STL:MRV:DE_
torsievrije	torsievrij	BNW:STL:VRB
torsievrijer	torsievrij	BNW:VGR:ONV
torsievrijere	torsievrij	BNW:VGR:VRB
preromaans	preromaans	BNW:STL:IET
onvergeten	onvergeten	BNW:STL:VRB
drachtduur	drachtduur	ZNW:EKV:DE_
geitachtigen	geitachtig	BNW:STL:MRV:DE_
goedsmoeds	goedsmoeds	BNW:STL:IET
koperblonde	koperblond	BNW:STL:VRB
lichtzwarte	lichtzwart	BNW:STL:VRB
maagbitter	maagbitter	ZNW:EKV:HET
doorkorven	doorkerven	WKW:VTD:ONV
verkorven	verkerven	WKW:VTD:VRB
ondervraagde	ondervragen	WKW:VLT:1EP
ondervraagden	ondervragen	WKW:VLT:INF
terugstiet	terugstoten	WKW:VLT:1EP
terugstiet	terugstoten	WKW:VLT:GIJ
uitstiet	uitstoten	WKW:VLT:1EP
uitstieten	uitstoten	WKW:VLT:INF
uitstiet	uitstoten	WKW:VLT:GIJ
verstiet	verstoten	WKW:VLT:1EP
vrage	terugvragen	WKW:AWS:LOS
vraag	terugvragen	WKW:TGW:1EP:LOS
vraagt	terugvragen	WKW:TGW:3EP:LOS
vraagde	terugvragen	WKW:VLT:1EP:LOS
vraagden	terugvragen	WKW:VLT:INF:LOS
vragen	terugvragen	WKW:TGW:INF:LOS
vroeg	terugvragen	WKW:VLT:1EP:LOS
vroegen	terugvragen	WKW:VLT:INF:LOS
meerbladige	meerbladig	BNW:STL:VRB
ongedraaide	ongedraaid	BNW:STL:VRB
valkachtigen	valkachtig	BNW:STL:MRV:DE_
bezitsloos	bezitsloos	BNW:STL:IET
bezitslozen	bezitsloos	BNW:STL:MRV:DE_
jodiumvrije	jodiumvrij	BNW:STL:VRB
dieselvlak	dieselvlak	ZNW:EKV:HET
eilandrijk	eilandrijk	ZNW:EKV:HET
eilandrijkje	eilandrijk	ZNW:EKV:VRK:HET
eilandrijkjes	eilandrijk	ZNW:MRV:VRK:DE_
eilandrijke	eilandrijk	BNW:STL:VRB
hotelmatige	hotelmatig	BNW:STL:VRB
indefinieten	indefiniet	BNW:STL:MRV:DE_
invariabelen	invariabel	BNW:STL:MRV:DE_
koudmakende	koudmakend	BNW:STL:VRB
onbezweken	onbezweken	BNW:STL:VRB
rommelvrije	rommelvrij	BNW:STL:VRB
schoolloos	schoolloos	BNW:STL:IET
waterblauwe	waterblauw	BNW:STL:VRB
welgemaakte	welgemaakt	BNW:STL:VRB
wortelloze	wortelloos	BNW:STL:VRB
wortelloos	wortelloos	BNW:STL:IET
polyamorie	polyamorie	ZNW:EKV:DE_
scopen	scopen	WKW:TGW:INF
scope	scopen	WKW:TGW:1EP
reistrip	reistrip	ZNW:EKV:DE_
reistripjes	reistrip	ZNW:MRV:VRK:DE_
reistrips	reistrip	ZNW:MRV:DE_
meetup	meetup	ZNW:EKV:DE_
meetups	meetup	ZNW:MRV:DE_
zeilschouw	zeilschouw	ZNW:EKV:DE_
zeilschouwen	zeilschouw	ZNW:MRV:DE_
koppelrijke	koppelrijk	BNW:STL:VRB
koppelrijkste	koppelrijk	BNW:OVR:VRB
koppelrijker	koppelrijk	BNW:VGR:ONV
carbonisch	carbonisch	BNW:STL:IET
dorpsgrond	dorpsgrond	ZNW:EKV:DE_
dorpsgronden	dorpsgrond	ZNW:MRV:DE_
filterloze	filterloos	BNW:STL:VRB
filterloos	filterloos	BNW:STL:IET
haaiachtigen	haaiachtig	BNW:STL:MRV:DE_
hulpgemaal	hulpgemaal	ZNW:EKV
hulpgemalen	hulpgemaal	ZNW:MRV:DE_
moedergans	moedergans	ZNW:EKV:DE_
moederganzen	moedergans	ZNW:MRV:DE_
ongeborgen	ongeborgen	BNW:STL:VRB
ongeborgene	ongeborgen	BNW:STL:EKV
rooklokaal	rooklokaal	ZNW:EKV:HET
rooklokalen	rooklokaal	ZNW:MRV:DE_
snellopende	snellopend	BNW:STL:VRB
springvlak	springvlak	ZNW:EKV:HET
springvlakken	springvlak	ZNW:MRV:DE_
stadwaartse	stadwaarts	BNW:STL:VRB
stadwaarts	stadwaarts	BNW:STL:IET
stiptelijk	stiptelijk	BYW
straaldruk	straaldruk	ZNW:EKV:DE_
zaagvormige	zaagvormig	BNW:STL:VRB
zone-eigen	zone-eigen	BNW:STL:VRB
ultrakleine	ultraklein	BNW:STL:VRB
neonoranje	neonoranje	BNW:STL:VRB
onironisch	onironisch	BNW:STL:IET
dieseldief	dieseldief	ZNW:EKV:DE_
dieseldieven	dieseldief	ZNW:MRV:DE_
holhoornigen	holhoornig	BNW:STL:MRV:DE_
kannibaals	kannibaals	BNW:STL:IET
ongevangen	ongevangen	BNW:STL:VRB
ongezongen	ongezongen	BNW:STL:VRB
opmaaktips	opmaaktip	ZNW:MRV:DE_
welstandige	welstandig	BNW:STL:VRB
welstandiger	welstandig	BNW:VGR:ONV
welstandigen	welstandig	BNW:STL:MRV:DE_
wolvenjong	wolvenjong	ZNW:EKV:HET
wolvenjongen	wolvenjong	ZNW:MRV:DE_
rasterloos	rasterloos	BNW:STL:IET
huisbakken	huisbakken	BNW:STL:VRB
aanvalvrije	aanvalvrij	BNW:STL:VRB
carbonlaag	carbonlaag	ZNW:EKV:DE_
carbonlagen	carbonlaag	ZNW:MRV:DE_
disseldruk	disseldruk	ZNW:EKV:DE_
galmstraal	galmstraal	ZNW:EKV:DE_
gezagsloos	gezagsloos	BNW:STL:IET
glutenrijke	glutenrijk	BNW:STL:VRB
leeslustigen	leeslustig	BNW:STL:MRV:DE_
hoogalpine	hoogalpine	BNW:STL:VRB
batchmatige	batchmatig	BNW:STL:VRB
buxusgrond	buxusgrond	ZNW:EKV:DE_
dieettrouw	dieettrouw	ZNW:EKV:DE_
dubbelstuk	dubbelstuk	ZNW:EKV:HET
dubbelstukje	dubbelstuk	ZNW:EKV:VRK:HET
kokosgrond	kokosgrond	ZNW:EKV:DE_
kuipvormige	kuipvormig	BNW:STL:VRB
kwartsrijke	kwartsrijk	BNW:STL:VRB
lastenvrije	lastenvrij	BNW:STL:VRB
onverminkte	onverminkt	BNW:STL:VRB
opnameweek	opnameweek	ZNW:EKV:DE_
parelzwarte	parelzwart	BNW:STL:VRB
plantgrond	plantgrond	ZNW:EKV:DE_
platenklem	platenklem	ZNW:EKV:DE_
platenklemmen	platenklem	ZNW:MRV:DE_
puntgelijke	puntgelijk	BNW:STL:VRB
regiematige	regiematig	BNW:STL:VRB
regiematiger	regiematig	BNW:VGR:ONV
serregrond	serregrond	ZNW:EKV:DE_
serregronden	serregrond	ZNW:MRV:DE_
slavendood	slavendood	ZNW:EKV:DE_
spreidbaren	spreidbaar	BNW:STL:MRV:DE_
stroomvrije	stroomvrij	BNW:STL:VRB
vruchtloze	vruchtloos	BNW:STL:VRB
vruchtloos	vruchtloos	BNW:STL:IET
residuloos	residuloos	BNW:STL:IET
hondenvrije	hondenvrij	BNW:STL:VRB
quotumvrije	quotumvrij	BNW:STL:VRB
strontvrije	strontvrij	BNW:STL:VRB
afdekgrond	afdekgrond	ZNW:EKV:DE_
afdekgronden	afdekgrond	ZNW:MRV:DE_
beeldmatige	beeldmatig	BNW:STL:VRB
beugelloze	beugelloos	BNW:STL:VRB
beugelloos	beugelloos	BNW:STL:IET
bovendijkse	bovendijks	BNW:STL:VRB
bovendijks	bovendijks	BNW:STL:IET
detailloze	detailloos	BNW:STL:VRB
detailloos	detailloos	BNW:STL:IET
godgeleerde	godgeleerd	BNW:STL:VRB
godgeleerden	godgeleerd	BNW:STL:MRV:DE_
herfstrode	herfstrood	BNW:STL:VRB
kledderende	kledderend	BNW:STL:VRB
koegerichte	koegericht	BNW:STL:VRB
logeertip	logeertip	ZNW:EKV:DE_
logeertips	logeertip	ZNW:MRV:DE_
luchtblauwe	luchtblauw	BNW:STL:VRB
onbehangen	onbehangen	BNW:STL:VRB
onvervolgde	onvervolgd	BNW:STL:VRB
pruikenbol	pruikenbol	ZNW:EKV:DE_
pruikenbollen	pruikenbol	ZNW:MRV:DE_
pruikenbolletje	pruikenbol	ZNW:EKV:VRK:HET
puntenlaag	puntenlaag	ZNW:EKV:DE_
puntenlagen	puntenlaag	ZNW:MRV:DE_
regeergeile	regeergeil	BNW:STL:VRB
regeergeilen	regeergeil	BNW:STL:MRV:DE_
regenstop	regenstop	ZNW:EKV:DE_
regenstops	regenstop	ZNW:MRV:DE_
schrikbaren	schrikbaar	BNW:STL:MRV:DE_
strijdloze	strijdloos	BNW:STL:VRB
strijdloos	strijdloos	BNW:STL:IET
superblauwe	superblauw	BNW:STL:VRB
superblonde	superblond	BNW:STL:VRB
teamtotaal	teamtotaal	ZNW:EKV:HET
vormenrijke	vormenrijk	BNW:STL:VRB
wegdeklaag	wegdeklaag	ZNW:EKV:DE_
wegdeklagen	wegdeklaag	ZNW:MRV:DE_
wereldweek	wereldweek	ZNW:EKV:DE_
wereldweken	wereldweek	ZNW:MRV:DE_
zanglokaal	zanglokaal	ZNW:EKV:HET
zanglokalen	zanglokaal	ZNW:MRV:DE_
zorglokaal	zorglokaal	ZNW:EKV:HET
zorglokalen	zorglokaal	ZNW:MRV:DE_
cementvrije	cementvrij	BNW:STL:VRB
geweldvrije	geweldvrij	BNW:STL:VRB
takkenvrije	takkenvrij	BNW:STL:VRB
arseenvrije	arseenvrij	BNW:STL:VRB
blauwbruine	blauwbruin	BNW:STL:VRB
boerenleed	boerenleed	ZNW:EKV:HET
bommenvrije	bommenvrij	BNW:STL:VRB
dromenrijke	dromenrijk	BNW:STL:VRB
dromenrijk	dromenrijk	ZNW:EKV:HET
gevolglijk	gevolglijk	BYW
grijsblonde	grijsblond	BNW:STL:VRB
kommerlijken	kommerlijk	BNW:STL:MRV:DE_
leugenvrije	leugenvrij	BNW:STL:VRB
megascherpe	megascherp	BNW:STL:VRB
oeverlicht	oeverlicht	ZNW:EKV:HET
onderduims	onderduims	BNW:STL:IET
onverbeten	onverbeten	BNW:STL:VRB
papierdruk	papierdruk	ZNW:EKV:DE_
papierdrukken	papierdruk	ZNW:MRV:DE_
plaquelaag	plaquelaag	ZNW:EKV:DE_
plaquelagen	plaquelaag	ZNW:MRV:DE_
rustlokaal	rustlokaal	ZNW:EKV:HET
rustlokalen	rustlokaal	ZNW:MRV:DE_
speciedruk	speciedruk	ZNW:EKV:DE_
speciedrukken	speciedruk	ZNW:MRV:DE_
steenblauwe	steenblauw	BNW:STL:VRB
streefdruk	streefdruk	ZNW:EKV:DE_
superlinkse	superlinks	BNW:STL:VRB
superlinks	superlinks	BNW:STL:IET
superlinksen	superlinks	BNW:STL:MRV:DE_
superzwarte	superzwart	BNW:STL:VRB
vingerveeg	vingerveeg	ZNW:EKV:DE_
vingervegen	vingerveeg	ZNW:MRV:DE_
wijdlopende	wijdlopend	BNW:STL:VRB
wortelvrije	wortelvrij	BNW:STL:VRB
zomerblauwe	zomerblauw	BNW:STL:VRB
zomerblonde	zomerblond	BNW:STL:VRB
ongebraden	ongebraden	BNW:STL:VRB
nieuwmelks	nieuwmelks	BNW:STL:IET
semirigide	semirigide	BNW:STL:VRB
elementale	elementaal	BNW:STL:VRB
elementalen	elementaal	BNW:STL:MRV:DE_
schuimvrije	schuimvrij	BNW:STL:VRB
onverdoken	onverdoken	BNW:STL:VRB
